1111111111111111111111111111111111111111111111111111111111111111111111111111111111111111111111111111
1111111111111111111111111111111111111111111111111111111111111111111111111111111111111111111111111111
1111111111111111111111111111111111111111111111111111111111111111111111111111111111111111111111111111
1111111111111111111111111111111111111111111111111111111111111111111111111111111111111111111111111111
1111111111111111111111111100000111100000011111111111111111111111111111111111111111111111111111111111
1111111111111111111111100000001000000000001101111111111111111111111111111111111111111111111111111111
1111111111111111111100000000010000000000000111111111110011111111111111111111111111111111111111111111
1111111111111111101000100001000000000000000111111111101111111111111111111111011111111111111111111111
1111111111111110111110110011100000000000000111111111111111111111111111111111001111111111111111111111
1111111111111111000001100011111100000000001111111111111111111111011111111000000111111111111111111111
1111111111111100111101000011111110000000011111111111111111111110111111100000000001111110111111111111
1111111111111100000111100000111110000000001111111111111111111110111111000000000000001111001111111111
1110000001111111000010011110001110000000001111111111100011111111111010000000000000000000000001111111
1100000000000000110000000111001110000001111111111111000000011100000000000000000000000000000000000001
1100000000000000000000000111000110000011111011111111000000110000000000000000000000000000000000000000
1111000000000000000000000011001111000111110011111110001000100000000000000000000000000000000000000011
1100000000000000000000011110111111101111111111111100010000000000000000000000000000000000000011001111
1110001111000000000000111110011111111111111111111100011000000000000000000000000000000000000110111111
1111001111100000000000001110000111111111111111101111010000000000000000000000000000000001111101111111
1111111111110000000000000100000011111111111111001110110000000000000000000000000000000011111001111111
1111111111111000000000000000000001111111111110100100000000000000000000000000000000000001111011111111
1111111111111000000000000000001101111111111111110000000000000000000000000000000000000001111111111111
1111111111111100000000011000001110111111111111100000000000000000000000000000000000000001110111111111
1111111111111100000000000100011111111111111111110000000011100110000000000000000000000011111111111111
1111111111111100000000000000111111111111111111000111010010110010000000000000000000001111111111111111
1111111111111100000000000001111111111111111111001111111100000011000000000000000000101111111111111111
1111111111111110000000000001111111111111111111110001111111000000000000000000000000101101111111111111
1111111111111111000000000011111111111111111111000000111111000000000000000000000001110111111111111111
1111111111111111000000110011111111111111111110000000000000000100000000000000000001111111111111111111
1111111111111111110001111001111111111111111110000000000000000011000000000000000001111111111111111111
1111111111111111111000111110111111111111111100000000000000100000000000000000000011111111111111111111
1111111111111111111000001111111111111111111100000000000000010000111000000100000111111111111111111111
1111111111111111111100001111111111111111111100000000000000010001111100001110000111111111111111111111
1111111111111111111111100111111111111111111100000000000000000111111100001111000111011111111111111111
1111111111111111111111110010000111111111111110000000000000000011111100011111101111011111111111111111
1111111111111111111111111100000001111111111111000000000000000011111110111111111111111111111111111111
1111111111111111111111111100000000111111111111111110000000000111111111111110111101111111111111111111
1111111111111111111111111100000000000111111111111110000000001111111111111111011001110111111111111111
1111111111111111111111111100000000000001111111111110000000011111111111111111011100111001110111111111
1111111111111111111111111100000000000000111111111111000000011111111111111111111111111110111111111111
1111111111111111111111111110000000000001111111111111000000011111111111111111111111111111101111111111
1111111111111111111111111110000000000011111111111111000000011111111111111111111111110011111111111111
1111111111111111111111111111000000000011111111111111000000011011111111111111111111000000011111111111
1111111111111111111111111111100000000011111111111111000000111011111111111111111110000000001111111111
1111111111111111111111111111100000000111111111111111000000110111111111111111111100000000001111111111
1111111111111111111111111111100000001111111111111111000001111111111111111111111100000000000111111111
1111111111111111111111111111000000011111111111111111100001111111111111111111111100000000000111111111
1111111111111111111111111111000001111111111111111111110011111111111111111111111100011000000111111111
1111111111111111111111111111000011111111111111111111111111111111111111111111111111111100001111110111
1111111111111111111111111111000111111111111111111111111111111111111111111111111111111111111111111011
1111111111111111111111111111001111111111111111111111111111111111111111111111111111111111011111111111
1111111111111111111111111111001111111111111111111111111111111111111111111111111111111111111111101111
1111111111111111111111111111001111111111111111111111111111111111111111111111111111111111111111111111
1111111111111111111111111111001111111111111111111111111111111111111111111111111111111111111111111111
1111111111111111111111111111011111111111111111111111111111111111111111111111111111111111111111111111
1111111111111111111111111111111111111111111111111111111111111111111111111111111111111111111111111111
1111111111111111111111111111111111111111111111111111111111111111111111111111111111111111111111111111
1111111111111111111111111111111111111111111111111111111111111111111111111111111111111111111111111111
1111111111111111111111111111111111111111111111111111111111111111111111111111111111111111111111111111
1111111111111111111111111111111111111111111111111111111111111111111111111111111111111111111111111111
